111111111111111111111111
100C00000000000C00000C11
101001010010000010100101
10110111101010100C100101
1001P1E00C00000000000001
111111111111111111111111