111111111111111111
1000000000000000E1
100000000000000001
100000000000000001
100000000P00000001
1C00000000010110C1
1000000000000C0001
111111111111111111