1111111111111111111
101000000C000000011
1010000000P00000001
11000000000000010E1
10000C0C0C0C0001001
1111111111111111111

0000000000000000000
0000000000000000000
0000000000000000000
0000000000000000000
0000000000000000000
0000000000000000000